WWWWWWWWWWWWWWWWWWWWWWWWWWWWWWWWWWWWWWWWWWWWWWWWWWWWWWWWWWWW
WFFFFFFFFFFFFFFFFWFWFFFWWFFFWFFFFFFFWWWWWWFFFFFWFFFWWFFFFFFW
WFWWWWWFWWWWWWWWFWFFFWFFFFWFWFWFWWWFFFFFFFFWWWFWFWFFFFWWWWFW
WFWFFFFFFFFFFWFFFWFWWWFWWWWFFFWWWFWWWWWWFWFFWFFFFWFWWWFFFFFW
WFWFWWWWWWFWFWFWFFFFFFFFFFWFWFFFFFFFFFFFFFFFFFWFFFFFFWFWWWFW
WFFFFFFFFFFWFWFWFWWWFWWWWFWFWWWWWFWWWFWWFWWWWFWWWWWWFWFWFFFW
WFWWWWWFWWFFFFFFFFFWWFFFWFFFFFFFFFFFFFFFFFFFFFFFWFFFFWFFFWFW
WFFFFFFFFFFWWWWWWWFFFFWFFFWWWWWWWFWWWWWWWFWFFFWFWFWFFWFWFWFW
WFWWFWWWWWFWFFFFFFFFFWFWFFFFFWFFFFWFFFFFFFWFFFWFWFWWFFFWFWFW
WFFFFFFFFFFWFFFFFFFFWWWWWFFFFWFFFFWFFFFFFFWWWWWFFFWFFWFWFFFW
WFWWWWWWWWFWWWWWWWFWFFFFFWFFFWFFFFWWWWWWWFWFFFWFWFWFWWWWFWFW
WFFFWFFFFFFFFFFFFFFFFFFFFFFFFFFWWFFFFFFFFFFFFFFFWFWFFFFFFWFW
WWWFWFWWWFWFWWFWFWFWWWWFWWWFWWWFFFWWWWWFWWWWWFWFWFFFWWWWFWFW
WFFFFFWFWFWFFFFFFWFFWFFFFFFFFWFFWWWFWFWFFFFFFFFFFFWFFFFFFFFW
WFWWWWWFFFWFWWWWFWWFWFWWWFFWFFFFWFWFWFWWWWWFWFWWWWWFWWWWWWFW
WFFFFFWWFFFFFFFWFFwFWFWFFFWWWWWFWFFFWFFFFFFFWFFFFFFFFFFFFFFW
WFWWWFFWFWWWWFWWWFFFWFFFWFFFFFFFFFWFWFWWFWWFWFWWWWWFWWWWFWWW
WFWFWWWWFFWFFFFFWWWFWFWWWFWWWWWWWFWFFFFFFFFFWFFFFFWFWWFFFFFW
WFWFFFFFFFFFWWWFFFFFWFFFFFFFFFFFFFFFWWWWWWWFFFWWWFFFFFFWWWFW
WWWWWWWWWWWWWWWWWWWWWWWWWWWWWWWWWWWWWWWWWWWWWWWWWWWWWWWWWWWW